XXXXXXXXXXXXXXXX
X--X--X-----T--X
XX-X-XXXXX-XXXXX
X----G-----X---X
XXXXXXX-X-XXX-XX
X--X-P--X---X--X
XX---XX---XXXX-X
X--X-X--X------X
XXXXXXXXXXXXXXXX