XXXXXXXXXXXXXXXXXXXXXXXXXXXXXXXXXXXXXXXXXXXXXXXXXXXXXXXXXXXXXXXXXXXXXXXXXXXXXXXXXXXXXXXXXXXXXXXXXXXXXXXXXXXX
X----------------------------------------------------------------------------------T-----------------------X
X----------------------------------------------------------------------------------------------------------X
X-------------------------------------------------------------------------------------------------T--------X
X--------------------------------------------------XXXXXXXXXXXXXXXXXXXX--------------------------TTT-------X
X-----------------------------------------------------------------------------------------------TTTTT------X
X--P-------------------------------------------------------------------------------------------TTTTTTT-----X
X-----------------------T---------------------------------------------------------------------TTTTTTTTT----X
X--------------------------------------T-----------TTTTTTTTTTTTTTTTTTTT------------T---------TTTTTTTTTTT--GX
XXXXXXXXXXXXXXXXXXXXXXXXXXXXXXXXXXXXXXXXXXXXXXXXXXXXXXXXXXXXXXXXXXXXXXXXXXXXXXXXXXXXXXXXXXXXXXXXXXXXXXXXXXXX
